30
....o.................o..oo.....oo......o.........
.o.o...........o...............o.......oo......o..
...o........o....ooo.o.....o.......ooooo...o......
.............o.................o..o...............
.........o...................o....................
.o....o.......o..o.....o..o.o..o......o..o.o..oo..
.o....o.....o..........oo.....o.....o....o.......o
....o.................oo....o.o........o.o........
.........o.........o............o.......o.........
......oo.oo...o...oo.................o...o...o...o
.......o............oo...o......o..o.o.....o..oo..
.o.............o..........o.......................
..............o.oo......oo....................o...
.....o...............o..........o..o............o.
...o.....o......o...o.....oo...............o......
.....o.....o.o...........ooo..o.....o....o.o......
......o......o..o....................o.ooo...o....
.............................o.....o.......o...o..
o.....o.......................o.o.o...............
o.......oo..................o..........o.....o....
.ooo.o.o...o.......o....o....o................o...
...oo....o.o...o.ooo......o.......................
....o.....oo........o.........o.....o.o...........
....o......o.....oo.o..............o....o...o.....
o..........o..o....o.......o...o........o.........
..............o......o.o....o................o.o..
...oo....o.ooo.oo..o.................oo.....o.....
...o......o......o.o..o...........o.....o.........
.....o.o..o........o.o......ooo....oo.o...........
.......o.o..o...o...o.oo...........................
